slave - рабыня/раб

pathetic - жалкий

scrap - клочок

dyed - покрашеный

nonsense - чушь

spitting - плевок

exhibition - выставка

nest - гнездо

bag of filth  - мешок с грязью

dare - осмелится

helm - шлем

entertaining - развлекательный

ray - луч

nuisance - неприятность

freed - освобожденный / освободить

annoying - раздражающий

horrid - ужасный

ridiculous -нелепый

convent - монастырь

crooked - изогнутый

gesture - жест

torch  - факел

talk fishy - подозрительно говорить

definitely - определенно

involving - включающий

bizarre - странный

possession - владение

sacrificial - жертвенный

chores - домашние дела

incredibly - невероятно

devoted - посвященный

screwed - пьяный разбитый

exactly - именно так

trace - след

obviously - очевидно

errands - поручения

splendid - великолепный

aware - осведомленный

medieval - средневековый

silly - глупый

booze -  выпивка

toe - палец ноги

senseless - бессмысленный

immediately - немедленно

otherwise - иначе

bald -лысый

meddling - надоедливый

wit - остроумие

persistent - стойкий

previously - ранний

abandoned - заброшенный

crippled - покалеченный

heaps - куча

reunited - воссоединенный

allied - союзный

mentor - наставник

hermit - отшельник

assume - предлагать

cradle - колыбель

precisely - точно

refusing - отказывающийся

sense - чувство

hardened - затвердевший

proper - правильный / точный

hilarious - веселый

furious - яростный

unearthly - неземной

rough - грубый

growl - рычание

erupt - извергаться

restraint - сдержанность

failure - неудача

blessed - благословенный